bbbbbbbbbbbbbbbbbbbbbbbbb
b                       b
b www   www   www   www b
b w       w   w       w b
b w ww ww w   w ww ww w b
b       w       w       b
b                       b
b       w       w       b
b w ww ww w   w ww ww w b
b w       w   w       w b
b www   www   www   www b
b                       b
bbbbbbbbbbbbbbbbbbbbbbbbb